4
7777777777
7288888837
78      87
788888b 87
788888b 87
788888b 87
788888b 87
78      87
7188888807
7777777777